1 1 1 1 1 1 1 1 1 1
4 0 0 0 0 0 0 0 0 3
4 0 0 0 0 0 0 0 0 3
4 0 0 0 0 0 0 0 0 3
4 0 0 0 -1 0 0 0 0 3
4 0 0 0 0 0 0 0 0 3
4 0 0 0 0 0 0 0 0 3
1 2 2 2 2 2 2 2 2 1
