3 3 1 2 4 4
3 -1 0 0 0 4
2 0 0 0 0 1
1 0 0 0 0 2
6 0 0 0 0 5
6 6 2 1 5 5
